###...#####
##......###
#...##...##
.##..##....
...@##.....
#........##
#..###....#
#...##....#
##..##...##
##...#..###
