##########
#..#.....#
#..#@....#
#..####..#
#.......##
####...#.#
#.....#..#
#....#...#
##.....###
##########
